0100010010
1001100100
1101110010
0110001001
0010110011
1111101111
0110100111
1101011001
0100010010
0000101011
