0111011101
0000000010
1100111001
0001000000
1001110111
1111000110
0101000110
1100101001
1011101100
1011001111
